#######
#o....#
#*.$..#
#o.*..#
#######
